11111111111111111111111111111111111111111111111111111111111111111111111111111111111111111111
10010000000C00000000000000000000000000000000000000000000000000000000000000000000000000000001
10000111110011111111111111111111111111111111111111111111111111111111111111111111111111111111
1P0011E0000011111111111111111111111111111111111111111111111111111111111111111111111111111111
11111111110011111111111111111111111111111111111111111111111111111111111111111111111111111111
10010000000C00000000000000000000000000000000000000000000000000000000000000000000000000000001
10000111110011111111111111111111111111111111111111111111111111111111111111111111111111111111
10010000000C00000000000000000000000000000000000000000000000000000000000000000000000000000001
10000111110011111111111111111111111111111111111111111111111111111111111111111111111111111111
10010000000C00000000000000000000000000000000000000000000000000000000000000000000000000000001
10000111110011111111111111111111111111111111111111111111111111111111111111111111111111111111
10010000000C00000000000000000000000000000000000000000000000000000000000000000000000000000001
10000111110011111111111111111111111111111111111111111111111111111111111111111111111111111111
10010000000C00000000000000000000000000000000000000000000000000000000000000000000000000000001
10000111110011111111111111111111111111111111111111111111111111111111111111111111111111111111
10010000000C00000000000000000000000000000000000000000000000000000000000000000000000000000001
10000111110011111111111111111111111111111111111111111111111111111111111111111111111111111111
10010000000C00000000000000000000000000000000000000000000000000000000000000000000000000000001
10000111110011111111111111111111111111111111111111111111111111111111111111111111111111111111
10010000000C00000000000000000000000000000000000000000000000000000000000000000000000000000001
10000111110011111111111111111111111111111111111111111111111111111111111111111111111111111111
10010000000C00000000000000000000000000000000000000000000000000000000000000000000000000000001
10000111110011111111111111111111111111111111111111111111111111111111111111111111111111111111
10010000000C00000000000000000000000000000000000000000000000000000000000000000000000000000001
11111111111111111111111111111111111111111111111111111111111111111111111111111111111111111111
10000111110011111111111111111111111111111111111111111111111111111111111111111111111111111111
10010000000C00000000000000000000000000000000000000000000000000000000000000000000000000000001
10000111110011111111111111111111111111111111111111111111111111111111111111111111111111111111
10010000000C00000000000000000000000000000000000000000000000000000000000000000000000000000001
10000111110011111111111111111111111111111111111111111111111111111111111111111111111111111111
10010000000C00000000000000000000000000000000000000000000000000000000000000000000000000000001
10000111110011111111111111111111111111111111111111111111111111111111111111111111111111111111
10010000000C00000000000000000000000000000000000000000000000000000000000000000000000000000001
10000111110011111111111111111111111111111111111111111111111111111111111111111111111111111111
10010000000C00000000000000000000000000000000000000000000000000000000000000000000000000000001
10000111110011111111111111111111111111111111111111111111111111111111111111111111111111111111
10010000000C00000000000000000000000000000000000000000000000000000000000000000000000000000001
10000111110011111111111111111111111111111111111111111111111111111111111111111111111111111111
10010000000C00000000000000000000000000000000000000000000000000000000000000000000000000000001
10000111110011111111111111111111111111111111111111111111111111111111111111111111111111111111
10010000000C00000000000000000000000000000000000000000000000000000000000000000000000000000001
11111111111111111111111111111111111111111111111111111111111111111111111111111111111111111111
10000111110011111111111111111111111111111111111111111111111111111111111111111111111111111111
10010000000C00000000000000000000000000000000000000000000000000000000000000000000000000000001
10000111110011111111111111111111111111111111111111111111111111111111111111111111111111111111
10010000000C00000000000000000000000000000000000000000000000000000000000000000000000000000001
10000111110011111111111111111111111111111111111111111111111111111111111111111111111111111111
10010000000C00000000000000000000000000000000000000000000000000000000000000000000000000000001
10000111110011111111111111111111111111111111111111111111111111111111111111111111111111111111
10010000000C00000000000000000000000000000000000000000000000000000000000000000000000000000001
10000111110011111111111111111111111111111111111111111111111111111111111111111111111111111111
10010000000C00000000000000000000000000000000000000000000000000000000000000000000000000000001
10000111110011111111111111111111111111111111111111111111111111111111111111111111111111111111
10010000000C00000000000000000000000000000000000000000000000000000000000000000000000000000001
10000111110011111111111111111111111111111111111111111111111111111111111111111111111111111111
10010000000C00000000000000000000000000000000000000000000000000000000000000000000000000000001
10000111110011111111111111111111111111111111111111111111111111111111111111111111111111111111
10010000000C00000000000000000000000000000000000000000000000000000000000000000000000000000001
11111111111111111111111111111111111111111111111111111111111111111111111111111111111111111111
10000111110011111111111111111111111111111111111111111111111111111111111111111111111111111111
10010000000C00000000000000000000000000000000000000000000000000000000000000000000000000000001
10000111110011111111111111111111111111111111111111111111111111111111111111111111111111111111
10010000000C00000000000000000000000000000000000000000000000000000000000000000000000000000001
10000111110011111111111111111111111111111111111111111111111111111111111111111111111111111111
10010000000C00000000000000000000000000000000000000000000000000000000000000000000000000000001
10000111110011111111111111111111111111111111111111111111111111111111111111111111111111111111
10010000000C00000000000000000000000000000000000000000000000000000000000000000000000000000001
10000111110011111111111111111111111111111111111111111111111111111111111111111111111111111111
10010000000C00000000000000000000000000000000000000000000000000000000000000000000000000000001
10000111110011111111111111111111111111111111111111111111111111111111111111111111111111111111
10010000000C00000000000000000000000000000000000000000000000000000000000000000000000000000001
10000111110011111111111111111111111111111111111111111111111111111111111111111111111111111111
10010000000C00000000000000000000000000000000000000000000000000000000000000000000000000000001
10000111110011111111111111111111111111111111111111111111111111111111111111111111111111111111
10010000000C00000000000000000000000000000000000000000000000000000000000000000000000000000001
11111111111111111111111111111111111111111111111111111111111111111111111111111111111111111111
10000111110011111111111111111111111111111111111111111111111111111111111111111111111111111111
10010000000C00000000000000000000000000000000000000000000000000000000000000000000000000000001
10000111110011111111111111111111111111111111111111111111111111111111111111111111111111111111
10010000000C00000000000000000000000000000000000000000000000000000000000000000000000000000001
10000111110011111111111111111111111111111111111111111111111111111111111111111111111111111111
10010000000C00000000000000000000000000000000000000000000000000000000000000000000000000000001
10000111110011111111111111111111111111111111111111111111111111111111111111111111111111111111
10010000000C00000000000000000000000000000000000000000000000000000000000000000000000000000001
10000111110011111111111111111111111111111111111111111111111111111111111111111111111111111111
10010000000C00000000000000000000000000000000000000000000000000000000000000000000000000000001
10000111110011111111111111111111111111111111111111111111111111111111111111111111111111111111
10010000000C00000000000000000000000000000000000000000000000000000000000000000000000000000001
10000111110011111111111111111111111111111111111111111111111111111111111111111111111111111111
10010000000C00000000000000000000000000000000000000000000000000000000000000000000000000000001
10000111110011111111111111111111111111111111111111111111111111111111111111111111111111111111
10010000000C00000000000000000000000000000000000000000000000000000000000000000000000000000001
11111111111111111111111111111111111111111111111111111111111111111111111111111111111111111111
10000111110011111111111111111111111111111111111111111111111111111111111111111111111111111111
10010000000C00000000000000000000000000000000000000000000000000000000000000000000000000000001
10000111110011111111111111111111111111111111111111111111111111111111111111111111111111111111
10010000000C00000000000000000000000000000000000000000000000000000000000000000000000000000001
10000111110011111111111111111111111111111111111111111111111111111111111111111111111111111111
10010000000C00000000000000000000000000000000000000000000000000000000000000000000000000000001
10000111110011111111111111111111111111111111111111111111111111111111111111111111111111111111
10010000000C00000000000000000000000000000000000000000000000000000000000000000000000000000001
10000111110011111111111111111111111111111111111111111111111111111111111111111111111111111111
10010000000C00000000000000000000000000000000000000000000000000000000000000000000000000000001
10000111110011111111111111111111111111111111111111111111111111111111111111111111111111111111
10010000000C00000000000000000000000000000000000000000000000000000000000000000000000000000001
10000111110011111111111111111111111111111111111111111111111111111111111111111111111111111111
10010000000C00000000000000000000000000000000000000000000000000000000000000000000000000000001
10000111110011111111111111111111111111111111111111111111111111111111111111111111111111111111
10010000000C00000000000000000000000000000000000000000000000000000000000000000000000000000001
11111111111111111111111111111111111111111111111111111111111111111111111111111111111111111111