111111111111111
100001000000001
10G001E0000G001
100001G0000G001
1GP000G00000001
100001G0000G001
100001G0000G001
100001G00G0G001
111111111111111