111111111111111
100001000000001
10C001E0000C001
100001C0000C001
1CP000C00000001
100001C0000C001
100001C0000C001
100001C00C0C001
111111111111111