11111111111111111
10000100000000001
10C000E0000C00001
101001C0000C00001
1CP000C0000000001
100001C0000C00001
10100111110C001C1
100001C00C0C00001
11111111111111111